333333333333333333333333333333333333
333333333333333333333333333333333333
330000000000000000000000000000000033
330000000000000000000000000000000033
330000000000000000000000000000000033
330000000000000000000000000000000033
330000000000000000000000000000000033
330000000000000000000000000000000033
330000000000000000000000000000000033
334444444444444444444444444444444433
222222222222222222222222222222222222
222222222222222222222222222222222222