333333333333333333333333333333333333
333333333333333333333333333333333333
33000010000003000X000000000000033333
3300P01110000000000000000003E1113333
33000X10000X030000000000000333333333
330W00100000030000000000000000000033
330000100003000000000000011333303333
3300010000030000000001111100X0000033
330000000X0300000000010C000333333333
334444444444444444444444444444444433
442222222222222222222222222222222244
222222222222222222222222222222222222