1111111111111
1000000000001
1000000E00001
1000000000001
1111110C00001
1000010000001
10P0010000001
1000010000001
1111111111111