111111111111111111111111111
100000000000000000000000001
10E0000000000000000000C0001
100000000000000000000000001
111111111111111111000000001
10000000C011000000000000001
1000P0000011000001111111111
100000000011000001000000001
111111110011000001011111101
1000000000110000010000C0101
100111111111000001111111101
100000000000000000000000001
100000000000111111111111111
100000000001000000000000001
100000000010000000000000001
100C00000100000000000000001
100000000100000000000000001
111111111111111111111111111