11111111
1P100001
11100C01
10E00001
11111111