111111111111111111111111111111111111111111111111111111
10E000000000000000000000000000000000000000000000000001
1CP000000000000000000000000000000000000000000000000001
111111111111111111111111111111111111111111111111111111