111111
10E001
1CP001
100001
111111