11111111
10100C01
1P100001
10100001
1E100001
10000001
11111111