11111111111111111111
10000000000000000001
10000000000000000001
100000000E0000000001
10000000000000000001
1000000000000C000001
11111111000000000001
10000001000000000001
100P0001000000000001
10000C01000000000001
11111111111111111111